#############
#E........B.#
#..C##B.....#
#..#..#..O..#
#.#.BB.#....#
#.T.#..O..O.#
#####S#######